pool	游泳池；水池	⠏⠕⠕⠇
wish	希望；願望	⠺⠊⠩
human	人類的；人類	⠓⠥⠍⠁⠝
risk	風險	⠗⠊⠎⠅
hopefully	但願	⠓⠕⠏⠑⠰⠇⠇⠽
nail	釘子；指甲	⠝⠁⠊⠇
bell	鈴	⠃⠑⠇⠇
blank	空白的；空格	⠃⠇⠁⠝⠅
blackboard	黑板	⠃⠇⠁⠉⠅⠃⠕⠜⠙
envelope	信封	⠢⠧⠑⠇⠕⠏⠑
stamp	郵票	⠌⠁⠍⠏
postcard	明信片	⠏⠕⠌⠉⠜⠙
mask	面具；口罩	⠍⠁⠎⠅
ring	戒指	⠗⠬
comb	梳子；梳	⠉⠕⠍⠃
tie	領帶	⠞⠊⠑
dot	點	⠙⠕⠞
match	相配	⠍⠁⠞⠡
belt	腰帶	⠃⠑⠇⠞
gas	汽油	⠛⠁⠎
pipe	管子	⠏⠊⠏⠑
drum	鼓	⠙⠗⠥⠍
violin	小提琴	⠧⠊⠕⠇⠔
bow	弦樂器的琴弓	⠃⠪
piano	鋼琴	⠏⠊⠁⠝⠕